2
02,22,1108,2060,1208,2460,1308,2460,1408,2460,1508,2460,1608,2460,1708,2460,1808,2460,1908,2460,2008,2460,2108,2360,1112,2060,1212,2460,1312,2460,1412,2460,1512,2460,1612,2460,1712,2460,1812,2460,1912,2460,2012,2460,2112,2360
09,01,02,1114,1860

4
03,03,1609,0924,1610,0924,1611,0924
01,28,1109,0930,1209,0930,1309,0930,1409,0930,1509,0930,1709,0930,1809,0930,1909,0930,2009,0930,2109,0930,1110,0930,1310,0930,1410,0930,1510,0930,1710,0930,1810,0930,1910,0930,2110,0930,1111,0930,1211,0930,1311,0930,1411,0930,1511,0930,1711,0930,1811,0930,1911,0930,2011,0930,2111,0930
04,01,2010,0409
09,02,03,1914,0824,04,1906,0309

0

2
10,04,1206,1103,1214,1103,2006,1103,2014,1103
11,04,00,1306,1109,01,1314,0812,03,2106,1130,02,2114,0212

1
09,01,13,1106,2200

//09인덱스는 개수, (관리할레이어, 화면좌표, 리소스좌표)
//11인덱스는 개수, (텍스트타입, 화면좌표, 리소스좌표)